wwwwwwwwwwwwwwwwwwwwwwwwwwwwwwwwwwwwwwwwwwwwwwww
wh............................................gw
wn............................................gw
wr............................................gw
wr............................................gw
wA............................................gw
wr............................................gw
wt............................................gw
wwwwwwwwwwwwwwwwwwwwwwwwwwwwwwwwwwwwwwwwwwwwwwww
