wwwwwwwwwwwwwwwwwwwwwwwwwwwwwwwwwwwwwwwwwwwwwwww
wh............................................gw
wn.......w....................................gw
wr....................w.......................gw
wr.............................ww.............gw
wA..............www..........................wgw
wr...............................ww...........gw
wt............................................gw
wwwwwwwwwwwwwwwwwwwwwwwwwwwwwwwwwwwwwwwwwwwwwwww
